maps/countryside.png

 *
#^

^#######################^
^                    *  ^
^  *                    ^
^              *        ^
^                       ^
^    ##  ^##  ^## ^ ^   ^
^   ^  ^ ^  ^ ^   ^ ^   ^
^   ^  ^ ^ *# ^   ^ ^   ^
^   ^  ^ ^##  ^## # #   ^
^   ^  ^ ^  ^ ^    ^  * ^
^ * ^  ^ ^  ^ ^    ^    ^
^   #  # ^* # ^  * ^    ^
^    ##  ###  ###  #    ^
^                       ^
^   *****************   ^
^                       ^
^                       ^
^  *                  * ^
#########################

