maps/lab.png

 ^A*
#@|l

#########################
# AAA^AAAAAA      # ^^^ #
# |||@||||||      # @@@ #
#                 #     #
# AAAAAAA^AA      ### ###
# |||||||@||        # # #
#                   * * #
# *                 l l #
# l                     #
          ^             #
          @             #
# *                     #
# l                     #
#                       #
# AAAAA^AAA^AAA^    ^^  #
# |||||@|||@|||@    @@  #
#                       #
#########################

