maps/resto.png

 []#
L()R

#########################
#                #      #
#  L[]R   L[]R   # L[]R #
#  L()R   L()R   # L()R #
#                #      #
#                ###  ###
#  L[]R   L[]R          #
#  L()R   L()R    L[]R  #
#                 L()R  #
#                       #
#  L[]R   L[]R          #
#  L()R   L()R   ###  ###
#                #LL  RR#
#                #LL  RR#
#  L[]R   L[]R   #LL  RR#
#  L()R   L()R   #LL  RR#
#                #LL  RR#
#########################

